房间号,请求时间,服务开始时间,服务结束时间,服务时长,风速,当前费用,费率
1,1,1,5,4,M,2.0,0.5
2,2,2,6,4,M,2.0,0.5
3,3,3,6,3,M,1.5,0.5
4,4,6,8,2,M,1.0,0.5
3,3,8,9,1,M,0.5,0.5
2,2,9,10,1,M,0.5,0.5
5,4,5,12,7,H,7.0,1.0
3,3,12,13,1,M,0.5,0.5
1,6,6,15,9,H,9.0,1.0
5,12,15,17,2,M,1.0,0.5
4,10,10,19,9,H,9.0,1.0
4,19,19,21,2,M,1.0,0.5
3,15,17,18,1,L,0.33,0.33
2,13,13,21,8,H,8.0,1.0
2,21,21,23,2,M,1.0,0.5
1,21,21,23,2,M,1.0,0.5
3,18,18,25,7,H,7.0,1.0
5,21,23,25,2,M,1.0,0.5
2,21,25,26,1,M,0.5,0.5
4,19,23,26,3,M,1.5,0.5
